[["S", "S", "S", "S", "S", "S", "S", "S", "S", "S", "S", "S", "S", "S", "S", "S", "S", "S", "S", "S"],
  ["S", "S", "S", "S", "S", "S", "B", "B", "B", "B", "B", "B", "S", "S", "S", "S", "S", "S", "S", "S"],
  ["S", "S", "B", "B", "B", "B", "B", "FT", "F", "F", "F", "B", "S", "S", "S", "S", "S", "S", "S", "S"],
  ["S", "S", "B", "F", "F", "B", "S", "F", "F", "FT", "F", "B", "S", "S", "S", "S", "S", "S", "S", "S"],
  ["S", "S", "B", "F", "F", "B", "S", "F", "F", "FT", "F", "B", "S", "S", "S", "S", "S", "S", "S", "S"],
  ["S", "B", "B", "F", "F", "B", "B", "F", "F", "F", "FT", "S", "B", "B", "B", "S", "S", "S", "S", "S"],
  ["S", "B", "FH", "W", "W", "B", "B", "B", "F", "F", "B", "B", "F", "F", "B", "S", "S", "S", "S", "S"],
  ["S", "B", "F", "W", "W", "W", "F", "F", "F", "F", "F", "F", "F", "F", "S", "S", "S", "S", "S", "S"],
  ["S", "B", "F", "W", "W", "W", "F", "F", "F", "F", "F", "F", "F", "F", "S", "S", "S", "S", "S", "S"],
  ["S", "B", "F", "F", "F", "F", "B", "B", "F", "F", "B", "B", "F", "F", "B", "S", "S", "S", "S", "S"],
  ["S", "B", "B", "B", "B", "B", "B", "B", "F", "F", "B", "B", "B", "B", "B", "S", "S", "S", "S", "S"],
  ["S", "S", "S", "S", "S", "S", "B", "F", "F", "F", "F", "B", "S", "S", "S", "S", "S", "S", "S", "S"],
  ["S", "S", "S", "S", "S", "S", "S", "F", "F", "F", "F", "S", "S", "S", "S", "S", "S", "S", "S", "S"],
  ["S", "S", "S", "S", "S", "S", "S", "F", "F", "F", "F", "S", "S", "S", "S", "S", "S", "S", "S", "S"],
  ["S", "S", "S", "S", "S", "S", "B", "F", "F", "F", "F", "B", "S", "S", "S", "S", "S", "S", "S", "S"],
  ["S", "S", "S", "S", "S", "S", "B", "B", "B", "B", "B", "B", "S", "S", "S", "S", "S", "S", "S", "S"],
  ["S", "S", "S", "S", "S", "S", "S", "S", "S", "S", "S", "S", "S", "S", "S", "S", "S", "S", "S", "S"],
  ["S", "S", "S", "S", "S", "S", "S", "S", "S", "S", "S", "S", "S", "S", "S", "S", "S", "S", "S", "S"],
  ["S", "S", "S", "S", "S", "S", "S", "S", "S", "S", "S", "S", "S", "S", "S", "S", "S", "S", "S", "S"],
  ["S", "S", "S", "S", "S", "S", "S", "S", "S", "S", "S", "S", "S", "S", "S", "S", "S", "S", "S", "S"]]